1111111111111111111111111
1111111111111111111111111
1111111111111111111111111
1111111111111111111111111
1111111111111111111111111
1111111111111111111111111
1111111111111111111111111
1111111111111111111111111
2111111111111111111111113
0000000000000000000000000
0000000000000000000000000
0000000000000000000000000
0000000000000000000000000
